######################
#              *     #
#                 D  #
#                    #
#   D                #
#                D   #
#              LDWL  #
#               WLD  #
#    D               #
#      D             #
#          D         #
#           W  D     #
#    LWD  D     W    #
#   LLDL   D D    D  #
#    WDW             #
#                   D#
#       D    D  D    #
#              D     #
#     *              #
#      D             #
#    L              L#
######################