######################
#                    #
#           D        #
#   W                #
#                  D #
#                    #
#                    #
#                    #
#       L            #
#      DLW           #
#       W            #
#                *   #
#                    #
#                    #
#                    #
#                    #
#                    #
#    D               #
#   DWD              #
#    D       D    D  #
#               D    #
######################